############
#          #
# P  ###   #
#    #     #
#       #  #
#      ##  #
#  #    #  #
# ##       X
# ##       #
#          #
#  E ####  #
############