############
#          #
#    ###   #
#    #     #
#       #  #
#    P ##  #
#  #    #  #
# ##       X
# ##       #
#          #
#  E ####  #
############