######################
#                    #
#                    #
#                    #
#                    #
#                    #
#                    #
#                    #
#                    #
#         P          X
#                    #
#                    #
#                    #
#                    #
#                    #
#                    #
#                    #
#                    #
#                    #
#                    #
######################